#############
#s  #     # #
### # ### # #
#s    # ### #
#### ## # #f#
#     # # # #
##### ### # #
#           #
#############
