#############
#s  #   # #f#
### # ### ###
#     # # # #
####### # # #
#       # # #
# ####### # #
#           #
#############
