#############
#s  #    ##f#
### # ### # #
#     # # # #
#### ## # # #
#       # # #
# ####### # #
#           #
#############
