#############
#s#   #   #f#
# # # # # # #
# # # # # # #
# # # # # # #
# # # # # # #
# # # # # # #
#   #   #   #
#############
