#############
#   #     # #
### # ### # #
#     # # # #
####  sf# # #
#       # # #
# ####### # #
#           #
#############
